111111111111
1001    1001
10N1    1001
1111    1111
