NO      ./textures/wall1.xpm


SO 			./textures/wall1.xpm
WE  	./textures/wall1.xpm

EA  	./textures/wall1.xpm
F  	220,100,0

C  225,30,0

111111111111
1001    1001
10N1    1001
1111    1111
