NO ./textures/wall3.xpm
SO ./textures/wall1.xpm
WE ./textures/debug.xpm
EA ./textures/wall2.xpm

C 72,205,241
F 72,111,56

111111111111
1001    1001
10N1    1001
1111    1111
