F 72,111,56

SO ./textures/wall2.xpm
EA ./textures/wall2.xpm


NO ./textures/wall2.xpm

C 72,205,241

WE ./textures/wall2.xpm
111111111
100000001
101111101
101000101
101000101
101101101
1000N0001
111111111