NO ./textures/debug.xpm
SO ./textures/debug.xpm
WE ./textures/debug.xpm
EA ./textures/debug.xpm

C 50,100,50
F 200,200,200

111111111111
100000000001
10000S000001
100000000001
100011100001
100011100001
100011100001
100011100001
100011100001
100011100001
100000000001
100000000001
100000000001
111111111111
