NO ./textures/wall2.xpm
SO ./textures/wall1.xpm
WE ./textures/wall1.xpm
EA ./textures/wall1.xpm

C 0,205,241
F 1,111,56


1111
1111
1111
