NO ./textures/wall3.xpm
SO ./textures/wall1.xpm
WE ./textures/debug.xpm
EA ./textures/wall2.xpm

C 72,205,241
F 72,111,56

   1
  101
 10N01
1111111
