F 72,111,56

SO ./textures/wall1.xpm
EA ./textures/wall1.xpm


NO ./textures/wall2.xpm

C 72,205,241

WE ./textures/wall1.xpm
   1
  101
 10N01
1111111
