F 72,111,56

SO ./textures/wall1.xpm
EA ./textures/wall1.xpm


NO ./textures/wall2.xpm

C 72,205,241

WE ./textures/wall1.xpm


11111
1E001
10101
10001
11111
