NO ./textures/wall3.xpm
SO ./textures/wall1.xpm
WE ./textures/debug.xpm
EA ./textures/wall2.xpm

C 72,205,241
F 72,111,56

1111111111111
1000000010001
1000110010001
1000110000001
1000000N01101
1000000001101
1000000001101
1001100000001
1001100000001
1001100000001
1001100000001
1000000000001
1111111111111
